Ferrari	法拉利
Karaloso	卡拉洛索
Khun	Khun
Milly	Milly
Nai Hua Laeng	乃华良
Nuea	努娅
P'	[泰语尊称]姐/兄
P'Nuea	[泰语尊称]Nuea姐
Parit	帕立
Pasut	帕苏
Pat	Pat
Pearl of the Andaman	安达曼明珠
Phuket	普吉岛
Prin	Prin
Prin Atthiwat	Prin Atthiwat
Riwkan Marina Yacht Club	Riwkan Marina游艇俱乐部
Ruth	Ruth
Saeng Nuea	Saeng Nuea
Saeng Nuea Thirakan	Saeng Nuea Thirakan
Sang Nuea	桑·努娅
Thira Kanlaya Marina Yacht Club	提拉卡纳亚游艇俱乐部
Thirakan Marina Yacht Club	Thirakan Marina游艇俱乐部
Thirakarn	提拉坎
Toppat	Toppat
Vivian	Vivian
oversized	宽松廓形